Name	title	coding
t3_qoec88	Construction Engineering and Management (MEng)	o
t3_qm5my8	looking for paid tutorials	c
t3_qo535h	Im in Software Engineering and I have two options next semester. Either to take the ENGR 233 with Chantal David but take the SOEN 228 with Donald Peter Davies. OR take ENGR 233 with Alexei Kokotov but take SOEN 228 with Hakim Mella . Which option should I go for?	c
t3_qpvjxz	DISC Inquiry	c
t3_qpe7hw	Housing Accomodation	r
t3_qphn14	Chance of concentration mechanical Beng to Soen	o
t3_qptic5	What kind of phone do you use? (Survey for a class)	o
t3_qlbox3	FINA Electives to be taken in which order?	c
t3_qqg6b9	How will theology department tests work when we return to school in January?	o
t3_qqhr4n	math 204 crash course?	c
t3_qoagdb	How do you DISC a class?	c
t3_qkrxur	Concordia Continuing Education worth it?	o
t3_ql2ywv	Does the FG building connect to the John Molson building?	o
t3_qly38g	COURSE QUESTION	c
t3_qq9nd3	Failed Math 208 Midterm	c
t3_qmoiy3	Do I have hope to pass my class?	c
t3_qnf3mt	To do checklist on student centre after I applied (I'm international so it asks for like visa expense documents, etc), do I need to do it before or after I have a decision?	o
t3_qpxh7l	PHYS 206 - Route of least resistance?	c
t3_qo4ris	DISC on DISC date?	c
t3_qpuhjr	Have four courses, planning to disc one tonight. Would I become a part time student?	c
t3_qq5d1b	COMP 335 Syllabus	c
t3_qogisc	Chem 203	c
t3_qktjdp	DISC classes - As an international student	c
t3_qo1ena	Anyone down to practice leetcode and tech interview questions?	o
t3_qp4jb2	Canadian citizen ship	o
t3_qm78z3	Winter 2022 Schedule Advice	o
t3_qpl3jr	Is graduate course withdrawal deadline today?	c
t3_qoamk1	Comm 210 help	c
t3_qnqr6v	Conditional Offer of Admission	o
t3_qq3qev	I need tutoring for engr 242 statics please send halp ğŸš€ğŸš€ğŸš€ğŸš€ğŸ™ğŸ»ğŸ™ğŸ»ğŸ™ğŸ»	c
t3_qky8gr	Disc a course.	c
t3_qp6cg0	Is there and art club or something that students from outside of fine arts can join?	o
t3_qple7p	Did not meet the requirements on conditional offer	o
t3_qm3emw	Confusion Regarding Admission	o
t3_qq6isg	PHYS204	c
t3_qnp9ug	Anyone down to play online games this weekend?	o
t3_qprn6y	Final year worries	o
t3_qmnj38	Freshman Questions	o
t3_qndfs9	Is there a limit to how many DISC you can have?	c
t3_qpr2og	Guys , whatâ€™s the best website/app to find apartments for rent for students?	r
t3_qoxt8d	What would people say is the easiest math course to take a Concordia?	c
t3_ql7n1t	acco 230 midterm	c
t3_qo26js	Permanent code international student.	o
t3_qljdz5	SOS TUTORING	c
t3_qmopar	Survey for our Statistics Class! :)	c
t3_qmdxoa	Gown	o
t3_qlkt9z	STL (Laval Buses) Strike: November 3rd, 15th, 26th	o
t3_qnrgvm	Coffee shops to study!	o
t3_qlvcl8	How is Nicolas Lepage-Saucier as a teacher?	o
t3_qmnn6h	Hard course load for winter?	c
